3 1 1 1 1 1 1 13 1 1 1 1 13 1 1 1 1 1 1 4
2 0 0 0 0 0 0 10 0 0 0 0 10 0 0 0 0 0 0 2
2 0 7 1 13 8 0 0 0 3 4 0 0 0 7 13 1 8 0 2
2 0 0 0 10 0 0 9 0 5 6 0 9 0 0 10 0 0 0 2
5 1 4 0 0 0 7 12 0 0 0 0 11 8 0 0 0 3 1 6
0 0 2 0 9 0 0 10 0 3 4 0 10 0 0 9 0 2 0 0
1 1 6 0 11 8 0 0 0 5 6 0 0 0 7 12 0 5 1 1
0 0 0 0 2 0 0 9 0 0 0 0 9 0 0 2 0 0 0 0
1 1 4 0 10 0 3 6 0 3 4 0 5 4 0 10 0 3 1 1
0 0 2 0 0 0 2 0 0 2 2 0 0 2 0 0 0 2 0 0
3 1 6 0 7 13 6 0 7 12 11 8 0 5 13 8 0 5 1 4
2 0 0 0 0 10 0 0 0 2 2 0 0 0 10 0 0 0 0 2
2 0 7 8 0 0 0 15 0 5 6 0 15 0 0 0 7 8 0 2
2 0 0 0 0 9 0 0 0 0 0 0 0 0 9 0 0 0 0 2
5 1 1 1 1 14 1 1 1 1 1 1 1 1 14 1 1 1 1 6

